###   ....║..║........║..║.
...   ..##╚══╣########╚══╬═
###   ######.║.......###.║.
###...######.║.......###.║.
.############║...##....##╠═
###......###.║.######....║.
###......###.║.######...   
.╔══╗...##...╚══╗..###..   
.║..║.###...###.║.###...   
.║.   ###...###.║.###...   
.║.   .....###══╩═════⌂.   
.║.   ......######......   
.║..........######...   .║.
.╚══════════════╗..⌂.   ###
................║....   ###
................║....######
.╔══╗...##...⌂..╠══╗..####═
.║..║...........║..║.######
.║..║...........║..║.      
.║..║##...⌂..⌂..║..╠═      
.║..║.###.......║..║.      
.║..║.###.......║..║.   ###
.║..║.....⌂..╔══╩══╝.   #╔═
.║..║.###.║..║.......   .║.
.║..║.###.║..║.   ....║..║.
.╚══╩══╗##╚══╝.   #.##╚══╝.
.......║.######   .........